agtagents.divisionID	crpnpcdivisions.divisionID
agtagents.corporationID	crpnpccorporations.corporationID
agtagents.locationID	mapdenormalize.itemID
agtagents.agentTypeID	agtagenttypes.agentTypeID
agtresearchagents.agentID	agtagents.agentID
agtresearchagents.typeID	invtypes.typeID
certcerts.groupID	invgroups.groupID
certmasteries.typeID	invtypes.typeID
certmasteries.certID	certcerts.certID
certskills.certID	certcerts.certID
certskills.skillID	invtypes.typeID
chrancestries.bloodlineID	chrbloodlines.bloodlineID
chrancestries.iconID	eveicons.iconID
chrattributes.iconID	eveicons.iconID
chrbloodlines.raceID	chrraces.raceID
chrbloodlines.shipTypeID	invtypes.typeID
chrbloodlines.corporationID	crpnpccorporations.corporationID
chrbloodlines.iconID	eveicons.iconID
chrfactions.solarSystemID	mapsolarsystems.solarSystemID
chrfactions.corporationID	crpnpccorporations.corporationID
chrfactions.militiaCorporationID	crpnpccorporations.corporationID
chrfactions.iconID	eveicons.iconID
chrraces.iconID	eveicons.iconID
crpnpccorporationdivisions.corporationID	crpnpccorporations.corporationID
crpnpccorporationdivisions.divisionID	crpnpcdivisions.divisionID
crpnpccorporationresearchfields.skillID	invtypes.typeID
crpnpccorporationresearchfields.corporationID	crpnpccorporations.corporationID
crpnpccorporations.solarSystemID	mapsolarsystems.solarSystemID
crpnpccorporations.friendID	crpnpccorporations.corporationID
crpnpccorporations.enemyID	crpnpccorporations.corporationID
crpnpccorporations.factionID	chrfactions.factionID
crpnpccorporations.iconID	eveicons.iconID
crpnpccorporationtrades.corporationID	crpnpccorporations.corporationID
crpnpccorporationtrades.typeID	invtypes.typeID
dgmattributetypes.iconID	eveicons.iconID
dgmattributetypes.unitID	eveunits.unitID
dgmattributetypes.categoryID	dgmattributecategories.categoryID
dgmeffects.iconID	eveicons.iconID
dgmeffects.durationAttributeID	dgmattributetypes.attributeID
dgmeffects.trackingSpeedAttributeID	dgmattributetypes.attributeID
dgmeffects.dischargeAttributeID	dgmattributetypes.attributeID
dgmeffects.rangeAttributeID	dgmattributetypes.attributeID
dgmeffects.falloffAttributeID	dgmattributetypes.attributeID
dgmeffects.npcUsageChanceAttributeID	dgmattributetypes.attributeID
dgmeffects.npcActivationChanceAttributeID	dgmattributetypes.attributeID
dgmeffects.fittingUsageChanceAttributeID	dgmattributetypes.attributeID
dgmexpressions.expressionTypeID	invtypes.typeID
dgmexpressions.expressionGroupID	invgroups.groupID
dgmexpressions.expressionAttributeID	dgmattributetypes.attributeID
dgmtypeattributes.typeID	invtypes.typeID
dgmtypeattributes.attributeID	dgmattributetypes.attributeID
dgmtypeeffects.typeID	invtypes.typeID
dgmtypeeffects.effectID	dgmeffects.effectID
industryactivity.typeID	invtypes.typeID
industryactivity.activityID	ramactivities.activityID
industryactivitymaterials.typeID	invtypes.typeID
industryactivitymaterials.activityID	ramactivities.activityID
industryactivitymaterials.materialTypeID	invtypes.typeID
industryactivityprobabilities.typeID	invtypes.typeID
industryactivityprobabilities.activityID	ramactivities.activityID
industryactivityprobabilities.productTypeID	invtypes.typeID
industryactivityproducts.typeID	invtypes.typeID
industryactivityproducts.activityID	ramactivities.activityID
industryactivityproducts.productTypeID	invtypes.typeID
industryactivityraces.typeID	invtypes.typeID
industryactivityraces.activityID	ramactivities.activityID
industryactivityraces.productTypeID	invtypes.typeID
industryactivityraces.raceID	chrraces.raceID
industryactivityskills.typeID	invtypes.typeID
industryactivityskills.activityID	ramactivities.activityID
industryactivityskills.skillID	invtypes.typeID
industryblueprints.typeID	invtypes.typeID
invcategories.iconID	eveicons.iconID
invcontrabandtypes.factionID	chrfactions.factionID
invcontrabandtypes.typeID	invtypes.typeID
invcontroltowerresources.controlTowerTypeID	invtypes.typeID
invcontroltowerresources.resourceTypeID	invtypes.typeID
invcontroltowerresources.factionID	chrfactions.factionID
invgroups.categoryID	invcategories.categoryID
invgroups.iconID	eveicons.iconID
invitems.typeID	invtypes.typeID
invitems.ownerID	invitems.itemID
invitems.locationID	mapdenormalize.itemID
invitems.flagID	invflags.flagID
invmarketgroups.parentGroupID	invmarketgroups.marketGroupID
invmarketgroups.iconID	eveicons.iconID
invmetagroups.iconID	eveicons.iconID
invmetatypes.typeID	invtypes.typeID
invmetatypes.parentTypeID	invtypes.typeID
invmetatypes.metaGroupID	invmetagroups.metaGroupID
invnames.itemID	invitems.itemID
invpositions.itemID	invitems.itemID
invtraits.typeID	invtypes.typeID
invtraits.skillID	invtypes.typeID
invtraits.unitID	eveunits.unitID
invtypematerials.typeID	invtypes.typeID
invtypematerials.materialTypeID	invtypes.typeID
invtypereactions.reactionTypeID	invtypes.typeID
invtypereactions.typeID	invtypes.typeID
invtypes.groupID	invgroups.groupID
invtypes.raceID	chrraces.raceID
invtypes.marketGroupID	invmarketgroups.marketGroupID
invtypes.iconID	eveicons.iconID
invtypes.graphicID	evegraphics.graphicID
invuniquenames.itemID	invitems.itemID
invuniquenames.groupID	invgroups.groupID
invvolumes.typeID	invtypes.typeID
mapcelestialstatistics.celestialID	invitems.itemID
mapconstellationjumps.fromRegionID	mapregions.regionID
mapconstellationjumps.fromConstellationID	mapconstellations.constellationID
mapconstellationjumps.toConstellationID	mapconstellations.constellationID
mapconstellationjumps.toRegionID	mapregions.regionID
mapconstellations.regionID	mapregions.regionID
mapconstellations.constellationID	mapconstellations.constellationID
mapconstellations.factionID	chrfactions.factionID
mapdenormalize.itemID	invitems.itemID
mapdenormalize.typeID	invtypes.typeID
mapdenormalize.groupID	invgroups.groupID
mapdenormalize.solarSystemID	mapsolarsystems.solarSystemID
mapdenormalize.constellationID	mapconstellations.constellationID
mapdenormalize.regionID	mapregions.regionID
mapdenormalize.orbitID	mapcelestialstatistics.celestialID
mapjumps.stargateID	mapdenormalize.itemID
mapjumps.destinationID	mapdenormalize.itemID
maplandmarks.locationID	mapdenormalize.itemID
maplandmarks.iconID	eveicons.iconID
maplocationscenes.locationID	mapdenormalize.itemID
maplocationscenes.graphicID	evegraphics.graphicID
maplocationwormholeclasses.locationID	mapdenormalize.itemID
mapregionjumps.fromRegionID	mapregions.regionID
mapregionjumps.toRegionID	mapregions.regionID
mapregions.factionID	chrfactions.factionID
mapsolarsystemjumps.fromRegionID	mapregions.regionID
mapsolarsystemjumps.fromConstellationID	mapconstellations.constellationID
mapsolarsystemjumps.fromSolarSystemID	mapsolarsystems.solarSystemID
mapsolarsystemjumps.toSolarSystemID	mapsolarsystems.solarSystemID
mapsolarsystemjumps.toConstellationID	mapconstellations.constellationID
mapsolarsystemjumps.toRegionID	mapregions.regionID
mapsolarsystems.regionID	mapregions.regionID
mapsolarsystems.constellationID	mapconstellations.constellationID
mapsolarsystems.factionID	chrfactions.factionID
mapsolarsystems.sunTypeID	invtypes.typeID
planetschematicspinmap.schematicID	planetschematics.schematicID
planetschematicspinmap.pinTypeID	invtypes.typeID
planetschematicstypemap.schematicID	planetschematics.schematicID
planetschematicstypemap.typeID	invtypes.typeID
ramassemblylinestations.stationID	stastations.stationID
ramassemblylinestations.assemblyLineTypeID	ramassemblylinetypes.assemblyLineTypeID
ramassemblylinestations.stationTypeID	stastationtypes.stationTypeID
ramassemblylinestations.ownerID	crpnpccorporations.corporationID
ramassemblylinestations.solarSystemID	mapsolarsystems.solarSystemID
ramassemblylinestations.regionID	mapregions.regionID
ramassemblylinetypedetailpercategory.assemblyLineTypeID	ramassemblylinetypes.assemblyLineTypeID
ramassemblylinetypedetailpercategory.categoryID	invgroups.categoryID
ramassemblylinetypedetailpergroup.assemblyLineTypeID	ramassemblylinetypes.assemblyLineTypeID
ramassemblylinetypedetailpergroup.groupID	invgroups.groupID
ramassemblylinetypes.activityID	ramactivities.activityID
raminstallationtypecontents.installationTypeID	invtypes.typeID
raminstallationtypecontents.assemblyLineTypeID	ramassemblylinetypes.assemblyLineTypeID
skinlicense.licenseTypeID	invtypes.typeID
skinlicense.skinID	skins.skinID
skins.skinMaterialID	skinmaterials.skinMaterialID
skinship.skinID	skins.skinID
skinship.typeID	invtypes.typeID
staoperations.activityID	crpactivities.activityID
staoperations.caldariStationTypeID	stastationtypes.stationTypeID
staoperations.minmatarStationTypeID	stastationtypes.stationTypeID
staoperations.amarrStationTypeID	stastationtypes.stationTypeID
staoperations.gallenteStationTypeID	stastationtypes.stationTypeID
staoperations.joveStationTypeID	stastationtypes.stationTypeID
staoperationservices.operationID	staoperations.operationID
staoperationservices.serviceID	staservices.serviceID
stastations.operationID	staoperations.operationID
stastations.stationTypeID	stastationtypes.stationTypeID
stastations.corporationID	crpnpccorporations.corporationID
stastations.solarSystemID	mapsolarsystems.solarSystemID
stastations.constellationID	mapconstellations.constellationID
stastations.regionID	mapregions.regionID
stastationtypes.operationID	staoperations.operationID
warcombatzones.factionID	chrfactions.factionID
warcombatzones.centerSystemID	mapsolarsystems.solarSystemID
warcombatzonesystems.solarSystemID	mapsolarsystems.solarSystemID
warcombatzonesystems.combatZoneID	warcombatzones.combatZoneID